11111111
1P000001
100000E1
11111111
11111111