1111111111111111
10011C10000000E1
1001100000000001
1000100000000001
1100000000000001
1111000000000001
1110000000011111
1100000000M01111
1110011100000011
100011C000000011
1P00110000001111
1111111111111111