1111111111111111111111111
1CE11000C0000000001100C01
1001110011001111001110001
1000100000010011001111001
1000001001100111000000001
1000M000000011100C0000001
100010010C001100100100001
1000111101111000100100001
1000011111100010000000001
1010000011000111000111001
1000111111000010000110001
10C0110000000000001110011
10001000C110C000001100111
1001100P01000111001111111
1111111111111111111111111