1111111111
10000011E1
1001111C01
1001000PM1
1000000111
1001000101
1001111101
1011010001
1000000001
1111111111