111111111111111
1CE110000000011
100111110001111
100010000000001
10000010011M001
100000000000001
100010000C00011
100011000000001
100001111100011
101000001100011
100011111100M11
10C010000000001
10001000C110C01
1001100P0100001
111111111111111