111111111111111111111111111111111111111111111
1000000000000000011111110000000000000011111C1
100P1111100001100000M001011111100011000111001
100000001111000111000C0100000011000110C010001
1001111M0101010001111111100000011100000000011
10001000000001C000001001111100010000001011011
101011111111011100000001000100000011100011011
10100011100000001111000000001110000000M000001
1000100110111000001111000M0000000111110100101
101100001100011100000111100001100010000100111
10C11100C00M00000C110C000110011000100111000E1
111111111111111111111111111111111111111111111