111111111111111111111111111111111111111111111
1000000000000000011111110000000000000011111C1
100P11111000011000000001011111100011000111001
100000001111000111000C0100000011000110C010001
100111100101010001111111100000011100000000011
1000100M000001C000001001111100010000001011011
101011111111011100000001000100000011100011011
101000111000000011110000000011100000000000001
100010011011100000111100000000000111110100101
101100001100011100000111100001100010000100111
10C11100C00000000C110C00011001100010001100001
110111101101010111011111001011100111100101011
100011111000011000000000011011100011000101001
100000001111000111000C0100000011000110C010001
100111100101010001111111100000011100000000011
10001000000001C000001001111100010000001011011
101011111111011100000001000100000011100011011
101000111000000011110000000011100000000000001
100010011011100000111100000000000111110100101
101100001100011100000111100001100010000100111
10C11100C00000000C110C000110011000100111000E1
111111111111111111111111111111111111111111111