1111111111111111
1001100000000111
1001111100011111
1000100000000001
100M001001100011
1000000000100001
1000100000000111
1000111110010011
100001C111010111
101E000011000111
100010000100M111
10001000P0000001
1111111111111111